learning breeds controversy.: विद्या में विवाद होना स्वाभाविक है।
kneel down and give thanks to God: घूटने टेको और ईश्वर को धन्यवाद दो
kindly grant me one day's leave: दया कर मुझे एक दिन की छुट्टी दें
keep quiet: शान्ति रखो
keep silence, please: क्रिप्या शान्त रहिए
keep pace with me: मेरे साथ पैर मिलाकर चलो
keep the change: इस रेजगारी को रखो
keep the fire going: आग बुझने न देना
keep to the left:बायें हाथ चलो
knowledge is power.: ज्ञान ही शक्ति है।
leave it to me: यह मुझपर छोड़ दो
leave me alone: मेरा पिण्ड छोड़ दो
leave now: मेरा पिण्ड छोड़ दो
let's go by bus: आओ बस में चलें
let's go for a bath: स्नान करने चलें
let's go for a walk: आओ घूमने चलें
let's go out for a walk: हमलोग टहलने चलें
let's have a scroll:टहलने के लिए आइए
let's have food now: आओ, अब खाना खाएं
let's see where he stands: देखें वह कितने पानी में है
let's work hard: आओ हम परिश्रम करें
let him come after all: वह आए तो सही
let it be: जाने दीजिए
let it remain inside: इसे अंदर ही रहने दो
let me have a look: मुझे देखने दो
let me have a look first: पहले देखूँ भी तो
let me introduce my self: मुझे अपना परिचय स्वयं देने दें
let me introduce you to my family: आइए, मैं आपको अपने परिवार से मिलाऊं
let me see: जरा देखने दो
let me work: मुझे काम करने दो
let the past bury the dead.: गड़े मुर्दे मत उखाड़ो।
let them play football: उन्हें फुटबाल खेलने दो    
let them relax: उन्हें आराम करने दीजिए
let these people do their work: इन लोगों को अपना काम करने दो
let this not happen in future: भविष्य में ऐसा न करना
light the lamp: दीया जला दो
something is better than nothing: कुछ होना कुछ नहीं होने से बेहतर है   
how did you know: आपको कैसे पता चला
what is your name?: आपका नाम क्या है?    
how do you do?: आप कैसे हैं?
what's up?: क्या चल रहा है?